LevelName=Tutorial
LevelNumber=1
Waves=5
EnemyPWave=10
LevelLayout:
NNNNNNNNNNNNNNNNNNNNNN
SPPPPPPPPPPNNNNNNNNNNN
NNNNNNNNNNPNNNNNNNNNNN
NNNNNNNNNNPNNNNNNNNNNN
NNNNNNPPPPPNNNNNNNNNNN
NNPPPPPNNNNNNNNNNNNNNN
NNPNNNNNNNNNNNNNNNNNNN
NNPPPPPPPPPPPNNNNNNNNN
NNNNNNNNNNNNPNNNNNNNNN
NNNNNNNNNPPPPNNNNNNNNN
NNNNNNNNNPNNNNNNNNNNNN
NNNNNNNNNPPPPPPPPPPPPN
NNNNNNNNNNNNNNNNNNNNPE
NNNNNNNNNNNNNNNNNNNNNN